111111111111
1EC110000001
10C110000001
10C11000P001
10C110000001
10C110000001
10C000000001
111111111111
